DATASET_COLORSTRIP
SEPARATOR TAB
DATASET_LABEL	kingdom
COLOR	#ff0000
DATA
Alternaria_alternata	#964B00	Fungi
Aspergillus_oryzae	#964B00	Fungi
Trichoglossum_hirsutum	#964B00	Fungi
Letharia_lupina	#964B00	Fungi
Botrytis_cinerea	#964B00	Fungi
Arthrobotrys_flagrans	#964B00	Fungi
Terfezia_boudieri	#964B00	Fungi
Fusarium_oxysporum	#964B00	Fungi
Agaricus_bisporus	#964B00	Fungi
Calocera_viscosa	#964B00	Fungi
Acaromyces_ingoldii	#964B00	Fungi
Puccinia_striiformis	#964B00	Fungi
Ustilago_maydis	#964B00	Fungi
Wallemia_mellicola	#964B00	Fungi
Batrachochytrium_dendrobatidis	#964B00	Fungi
Rhizophagus_irregularis	#964B00	Fungi
Mortierella_hygrophila	#964B00	Fungi
Basidiobolus_meristosporus	#964B00	Fungi
Dimargaris_cristalligena	#964B00	Fungi
Conidiobolus_coronatus	#964B00	Fungi
Coemansia_reversa	#964B00	Fungi
Thamnocephalis_sphaerospora	#964B00	Fungi
Helobdella_robusta	#ffff00	Metazoa
Capitella_teleta	#ffff00	Metazoa
Trichonephila_clavata	#ffff00	Metazoa
Ladona_fulva	#ffff00	Metazoa
Lingula_anatina	#ffff00	Metazoa
Bugula_neritina	#ffff00	Metazoa
Danio_rerio	#ffff00	Metazoa
Xenopus_laevis	#ffff00	Metazoa
Ciona_intestinalis	#ffff00	Metazoa
Gallus_gallus	#ffff00	Metazoa
Callorhinchus_milii	#ffff00	Metazoa
Erpetoichthys_calabaricus	#ffff00	Metazoa
Anolis_carolinensis	#ffff00	Metazoa
Branchiostoma_lanceolatum	#ffff00	Metazoa
Homo_sapiens	#ffff00	Metazoa
Actinia_tenebrosa	#ffff00	Metazoa
Clytia_hemisphaerica	#ffff00	Metazoa
Acanthaster_planci	#ffff00	Metazoa
Strongylocentrotus_purpuratus	#ffff00	Metazoa
Holothuria_leucospilota	#ffff00	Metazoa
Mytilus_edulis	#ffff00	Metazoa
Octopus_vulgaris	#ffff00	Metazoa
Lottia_gigantea	#ffff00	Metazoa
Caenorhabditis_elegans	#ffff00	Metazoa
Schistosoma_mansoni	#ffff00	Metazoa
Amphimedon_queenslandica	#ffff00	Metazoa
Didymodactylos_carnosus	#ffff00	Metazoa
Edaphobacter_modestus	#FFFFFF	nan
Luteitalea_pratensis	#FFFFFF	nan
Candidatus_Microthrix_parvicella	#FFFFFF	nan
Streptomyces_coelicolor	#FFFFFF	nan
Fimbriimonas_ginsengisoli	#FFFFFF	nan
Fragilariopsis_cylindrus	#FFFFFF	nan
Thalassiosira_oceanica	#FFFFFF	nan
Chitinophaga_japonensis	#FFFFFF	nan
Echinicola_pacifica	#FFFFFF	nan
Flavobacterium_macacae	#FFFFFF	nan
Haliscomenobacter_hydrossis	#FFFFFF	nan
Mucilaginibacter_frigoritolerans	#FFFFFF	nan
Ktedonospora_formicarum	#FFFFFF	nan
Pseudocohnilembus_persalinus	#FFFFFF	nan
Stylonychia_lemnae	#FFFFFF	nan
Deinococcus_yavapaiensis	#FFFFFF	nan
Plasmodiophora_brassicae	#FFFFFF	nan
Dictyostelium_discoideum	#FFFFFF	nan
Peribacillus_psychrosaccharolyticus	#FFFFFF	nan
Sporotomaculum_syntrophicum	#FFFFFF	nan
Longimicrobium_terrae	#FFFFFF	nan
Hondaea_fermentalgiana	#FFFFFF	nan
Salpingoeca_rosetta	#FFFFFF	nan
Polarella_glacialis	#FFFFFF	nan
Nannochloropsis_gaditana	#FFFFFF	nan
Sphaeroforma_arctica	#FFFFFF	nan
Aureococcus_anophagefferens	#FFFFFF	nan
Ectocarpus_siliculosus	#FFFFFF	nan
Tribonema_minus	#FFFFFF	nan
Candidatus_Nitrospira_nitrosa	#FFFFFF	nan
Rubripirellula_lacrimiformis	#FFFFFF	nan
Rhizobium_etli	#FFFFFF	nan
Burkholderia_pseudomallei	#FFFFFF	nan
Cystobacter_ferrugineus	#FFFFFF	nan
Pseudomonas_asplenii	#FFFFFF	nan
Galdieria_sulphuraria	#FFFFFF	nan
Gracilariopsis_chorda	#FFFFFF	nan
Nitrososphaeraceae_archaeon	#FFFFFF	nan
Luteolibacter_ambystomatis	#FFFFFF	nan
Chlamydomonas_reinhardtii	#00FF00	Viridiplantae
Chloropicon_primus	#00FF00	Viridiplantae
Chlorella_variabilis	#00FF00	Viridiplantae
Physcomitrium_patens	#00FF00	Viridiplantae
Chara_braunii	#00FF00	Viridiplantae
Klebsormidium_nitens	#00FF00	Viridiplantae
Populus_trichocarpa	#00FF00	Viridiplantae
Marchantia_polymorpha	#00FF00	Viridiplantae
Adiantum_capillus-veneris	#00FF00	Viridiplantae
